27x14
###########################
#   B                     #
#                         #
# D     DDDDDDDDDDDDDDDDD #
#                   D     #
#      B                  #
#                         #
#          B              #
#  O                      #
#       M                 #
#                         #
#                  M      #
#                         #
###########################
